justKeysandRooms
An Interactive Fiction by SenseiCanada
Release 1 / Serial number 221111 / Inform 7 v10.1.2 / D

kitchen
The kitchen of a basement apartment. The bathroom is to the north, the living room is east, and the entrance hall is south. There is a leak coming from somewhere, you are standing in 5 cm of water. There is muffled whirring sound coming from the green bathroom door. 

You can see a green door, a counter and a kitchen cabinet (closed) here.

>e
living room
From one of the couches, an orange taby blearily opens one eye and stares at you reproachfully

You can see a couch (on which is a cat) here.

>x cat
You see nothing special about the cat.

* * *

justKeysandRooms
An Interactive Fiction by SenseiCanada
Release 1 / Serial number 221111 / Inform 7 v10.1.2 / D

kitchen
The kitchen of a basement apartment. The bathroom is to the north, the living room is east, and the entrance hall is south. There is a leak coming from somewhere, you are standing in 5 cm of water. There is muffled whirring sound coming from the green bathroom door. 

You can see a green door, a counter and a kitchen cabinet (closed) here.

>Test win with "open cabinet / take can of fish / go s / x cat".
I only understood you as far as wanting to test that.

>Test "open cabinet / take can of fish / go s / x cat".
I only understood you as far as wanting to test that.

>Test with "open cabinet / take can of fish / go s / x cat".
I only understood you as far as wanting to test that.

>open cabinet / take can of fish / go s / x cat
I only understood you as far as wanting to open the kitchen cabinet.

>"open cabinet / take can of fish / go s / x cat",
You seem to want to talk to someone, but I can't see whom.

>open cabinet
There is a flat can of fish in the cabinet, sardines to be exact.

The water is 5 cm high.

>take fish
Taken.

The water is 6 cm high.

>go e
living room
From one of the couches, an orange taby blearily opens one eye and stares at you reproachfully

You can see a couch (on which is a cat) here.

The water is 7 cm high.

>x cat
Around the cat's collar dangles a silver key.

The water is 8 cm high.

>ask cat for key
The cat wriggles away, preventing you from unhooking the silver key from its colar. Perhaps some food would keep it still long enough to take the key...

The water is 9 cm high.

>go w
kitchen
The kitchen of a basement appartment. The bathroom is to the north, the living room is east, and the entrance hall is south. There is muffled whirring sound coming from the green bathroom door. 

You can see a green door, a counter and a kitchen cabinet (empty) here.

The water is 10 cm high.

>go s
entrance hall
You can here the pounding of rain outside. From beneath the front door, cold, muddy water flows down the steps into the basement appartment. The lock on the front door is brass-colored.

You can see a front door and a shelf (on which is a pocket knife) here.

The water is 11 cm high.

>take knife
Taken.

The water is 12 cm high.

>unlock can of fish
What do you want to unlock the can of fish with?

>knife
You unlock the can of fish.

The water is 13 cm high.

>x fish
You see nothing special about the can of fish.

The water is 14 cm high.

>take sardines
You can't see any such thing.

* * *

justKeysandRooms
An Interactive Fiction by SenseiCanada
Release 1 / Serial number 221111 / Inform 7 v10.1.2 / D

kitchen
The kitchen of a basement apartment. The bathroom is to the north, the living room is east, and the entrance hall is south. There is a leak coming from somewhere, you are standing in 5 cm of water. There is muffled whirring sound coming from the green bathroom door. 

You can see a green door, a counter and a kitchen cabinet (closed) here.

>enter door
(first opening the green door)
It seems to be locked.

* * *

justKeysandRooms
An Interactive Fiction by SenseiCanada
Release 1 / Serial number 221111 / Inform 7 v10.1.2 / D

kitchen
The kitchen of a basement apartment. The bathroom is to the north, the living room is east, and the entrance hall is south. There is a leak coming from somewhere, you are standing in 5 cm of water. There is muffled whirring sound coming from the green bathroom door. 

You can see a green door, a counter and a kitchen cabinet (closed) here.

>go e
living room
From one of the couches, an orange taby blearily opens one eye and stares at you reproachfully

You can see a couch (on which is a cat) here.

The water is 0 feet  high.

>go w
kitchen
The kitchen of a basement appartment. The bathroom is to the north, the living room is east, and the entrance hall is south. There is muffled whirring sound coming from the green bathroom door. 

You can see a green door, a counter and a cabinet (closed) here.

The water is 1 foot  high.

* * *

justKeysandRooms
An Interactive Fiction by SenseiCanada
Release 1 / Serial number 221111 / Inform 7 v10.1.2 / D

kitchen
The kitchen of a basement apartment. The bathroom is to the north, the living room is east, and the entrance hall is south. There is a leak coming from somewhere, you are standing in 5 cm of water. There is muffled whirring sound coming from the green bathroom door. 

You can see a green door, a counter and a kitchen cabinet (closed) here.

>go east
living room
From one of the couches, an orange taby blearily opens one eye and stares at you reproachfully

You can see a couch (on which is a cat) here.

The water is 5 cm high.

>i
You are carrying nothing.

>x
What do you want to examine?

>x livingroom
You can't see any such thing.

>x living room
You can't see any such thing.

>look
living room

* * *

>go east
living room
From one of the couches, an orange taby blearily opens one eye and stares at you reproachfully

You can see a couch (on which is a cat) here.

The water is 5 cm high.

>pet cat
That's not a verb I recognise.

>go east
You can't go that way.

The water is 9 cm high.

>go west
kitchen
The kitchen of a basement apartment. The bathroom is to the north, the living room is east, and the entrance hall is south. There is a leak coming from somewhere, you are standing in 13 cm of water. There is muffled whirring sound coming from the green bathroom door. 

You can see a green door, a counter and a kitchen cabinet (closed) here.

The water is 13 cm high.

>examine room
You can't see any such thing.

>examine kitchen
You see nothing special about the kitchen cabinet.

The water is 17 cm high.

>go east
living room
From one of the couches, an orange taby blearily opens one eye and stares at you reproachfully

You can see a couch (on which is a cat) here.

The water is 21 cm high.

>examine living room
You can't see any such thing.

>examine cat
Around the cat's collar dangles a silver key.

The water is 25 cm high.

>take cat
I don't suppose the cat would care for that.

The water is 29 cm high.

>take key
That seems to belong to the cat.

The water is 33 cm high.

>kiss cat
The cat might not like that.

The water is 37 cm high.

>ask the cat for the key
The cat wriggles away, preventing you from unhooking the silver key from its colar. Perhaps some food would keep it still long enough to take the key...

The water is 41 cm high.

>give cat fish
You can't see any such thing.

>give cat treat
You can't see any such thing.

>give cat food
You can't see any such thing.

>go west
kitchen
The kitchen of a basement apartment. The bathroom is to the north, the living room is east, and the entrance hall is south. There is a leak coming from somewhere, you are standing in 45 cm of water. There is muffled whirring sound coming from the green bathroom door. 

You can see a green door, a counter and a kitchen cabinet (closed) here.

The water is 45 cm high.

>find food
That's not a verb I recognise.

>look for food
You can't see any such thing.

>open fridge
You can't see any such thing.

>open cabinet
There is a flat can of fish in the cabinet, sardines to be exact.

The water is 49 cm high.

>take fish
Taken.

The water is 53 cm high.

>go east
living room
From one of the couches, an orange taby blearily opens one eye and stares at you reproachfully

You can see a couch (on which is a cat) here.

The water is 57 cm high.

>give cat fish
The cat doesn't seem interested.

The water is 61 cm high.

>open can
It seems to be locked.

The water is 65 cm high.

>give fish to cat
The cat doesn't seem interested.

The water is 69 cm high.

>unlock can
(with the can of fish)
That doesn't seem to fit the lock.

The water is 73 cm high.

>use can opener to open can of fish
That's not a verb I recognise.

>throw can of fish at cat
You lack the nerve when it comes to the crucial moment.

The water is 77 cm high.

>go west
kitchen
The kitchen of a basement apartment. The bathroom is to the north, the living room is east, and the entrance hall is south. There is a leak coming from somewhere, you are standing in 81 cm of water. There is muffled whirring sound coming from the green bathroom door. 

You can see a green door, a counter and a kitchen cabinet (empty) here.

The water is 81 cm high.

>go south
entrance hall
You can hear the pounding of rain outside. From beneath the front door, cold, muddy water flows down the steps into the basement ap artment. The lock on the front door is brass-colored.

You can see a front door and a shelf (on which is a pocket knife) here.

The water is 85 cm high.

>take pocket knife
Taken.

The water is 89 cm high.

>open can with pocket knife
There are sardines in the can.

The water is 93 cm high.

>go north
kitchen
The kitchen of a basement apartment. The bathroom is to the north, the living room is east, and the entrance hall is south. There is a leak coming from somewhere, you are standing in 97 cm of water. There is muffled whirring sound coming from the green bathroom door. 

You can see a green door, a counter and a kitchen cabinet (empty) here.

The water is 97 cm high.

>go east
living room
From one of the couches, an orange taby blearily opens one eye and stares at you reproachfully

You can see a couch (on which is a cat) here.

You hear a faint sparking sound from the bathroom. All of a sudden a jolt of electricity courses through your bady and you collapse onto the floor. GAME OVER.

    *** The End ***

Would you like to RESTART, RESTORE a saved game, QUIT or UNDO the last command?

* * *

>go east
living room
From one of the couches, an orange taby blearily opens one eye and stares at you reproachfully

You can see a couch (on which is a cat) here.

The water is 5 cm high.

>x cat
You see nothing special about the cat.

>take key from cat
That seems to belong to the cat.

* * *

justKeysandRooms
An Interactive Fiction by SenseiCanada
Release 1 / Serial number 221111 / Inform 7 v10.1.2 / D

kitchen
The kitchen of a basement apartment. The bathroom is to the north, the living room is east, and the entrance hall is south. There is a leak coming from somewhere, you are standing in 5 cm of water. There is muffled whirring sound coming from the green bathroom door. 

You can see a green door, a counter and a kitchen cabinet (closed) here.

>go east
living room
From one of the couches, an orange taby blearily opens one eye and stares at you reproachfully

You can see a couch (on which is a cat) here.

>x cat
Around the cat's collar dangles a silver key.

>go s
You can't go that way.

>go kitchen
You can't see any such thing.

>go w
kitchen
You can see a green door and a counter (on which is a screwdriver) here.

>go s
entrance hall

>x
What do you want to examine?

* * *

justKeysandRooms
An Interactive Fiction by SenseiCanada
Release 1 / Serial number 221111 / Inform 7 v10.1.2 / D

kitchen
The kitchen of a basement apartment. The bathroom is to the north, the living room is east, and the entrance hall is south. There is a leak coming from somewhere, you are standing in 5 cm of water. There is muffled whirring sound coming from the green bathroom door. 

You can see a green door, a counter and a kitchen cabinet (closed) here.

>go north
(first opening the green door)
It seems to be locked.

The water is 5 cm high.

>unlock door
What do you want to unlock the green door with?

>a key
You can't see any such thing.

>bust it open
That's not a verb I recognise.

>go south
entrance hall
You can hear the pounding of rain outside. From beneath the front door, cold, muddy water flows down the steps into the basement appartment. The lock on the front door is brass-colored.

You can see a front door and a shelf (on which is a pocket knife) here.

The water is 9 cm high.

>grab pocket knife
That's not a verb I recognise.

>take pocket knife
Taken.

The water is 13 cm high.

>go north
kitchen
The kitchen of a basement appartment. The bathroom is to the north, the living room is east, and the entrance hall is south. There is a leak coming from somewhere, you are standing in 17 cm of water. There is muffled whirring sound coming from the green bathroom door. 

You can see a green door, a counter and a kitchen cabinet (closed) here.

The water is 17 cm high.

>go north
(first opening the green door)
It seems to be locked.

The water is 21 cm high.

>open with pocket knife
You can't see any such thing.

>use pocket knife
That's not a verb I recognise.

>insert pocket knife
(in the pocket knife)
You can't put something inside itself.

The water is 25 cm high.

>insert pocket knife in lock
You can't see any such thing.

>unlock door
(with the pocket knife)
That doesn't seem to fit the lock.

The water is 29 cm high.

>go south
entrance hall
You can hear the pounding of rain outside. From beneath the front door, cold, muddy water flows down the steps into the basement appartment. The lock on the front door is brass-colored.

You can see a front door and a shelf here.

The water is 33 cm high.

>go east
You can't go that way.

The water is 37 cm high.

>go west
You can't go that way.

The water is 41 cm high.

>go south
(first opening the front door)

street
You can see a front door here.

You made it out of the locked appartment. As you wade into the flooded street you hear a faint sparking sound from the appartment. All of a sudden a jolt of electricity courses through your body and you collapse into the muddy floodwater. GAME OVER.

    *** The End ***

Would you like to RESTART, RESTORE a saved game, QUIT or UNDO the last command?

* * *

justKeysandRooms
An Interactive Fiction by SenseiCanada
Release 1 / Serial number 221111 / Inform 7 v10.1.2 / D

kitchen
The kitchen of a basement apartment. The bathroom is to the north, the living room is east, and the entrance hall is south. There is a leak coming from somewhere, you are standing in 5 cm of water. There is muffled whirring sound coming from the green bathroom door. 

You can see a green door, a counter and a kitchen cabinet (closed) here.

>go s
entrance hall
You can here the pounding of rain outside. From beneath the front door, cold, muddy water flows down the steps into the basement appartment.

You can see a front door here.

The water is 0 feet  high.

>go n
kitchen
The kitchen of a basement appartment. The bathroom is to the north, the living room is east, and the entrance hall is south.

You can see a green door and a counter (on which is a screwdriver) here.

The water is 1 foot  high.

>go s
entrance hall
You can here the pounding of rain outside. From beneath the front door, cold, muddy water flows down the steps into the basement appartment.

You can see a front door here.

The water is 2 feet  high.

* * *

justKeysandRooms
An Interactive Fiction by SenseiCanada
Release 1 / Serial number 221111 / Inform 7 v10.1.2 / D

kitchen
The kitchen of a basement apartment. The bathroom is to the north, the living room is east, and the entrance hall is south. There is a leak coming from somewhere, you are standing in 5 cm of water. There is muffled whirring sound coming from the green bathroom door. 

You can see a green door, a counter and a kitchen cabinet (closed) here.

>go to the green door
You can't see any such thing.

>go to the bathroom door
You can't see any such thing.

>go north
(first opening the green door)
It seems to be locked.

The water is 5 cm high.

>go to the kitchen cabinet
You can't see any such thing.

>open the kitchen cabinet
There is a flat can of fish in the cabinet, sardines to be exact.

The water is 9 cm high.

>eat the sardines
You can't see any such thing.

>go south
entrance hall
You can here the pounding of rain outside. From beneath the front door, cold, muddy water flows down the steps into the basement appartment. The lock on the front door is brass-colored.

You can see a front door and a shelf (on which is a pocket knife) here.

The water is 13 cm high.

>grab the pocket knife
That's not a verb I recognise.

>take the pocket knife
Taken.

The water is 17 cm high.

>go east
You can't go that way.

The water is 21 cm high.

>go north
kitchen
The kitchen of a basement appartment. The bathroom is to the north, the living room is east, and the entrance hall is south. There is a leak coming from somewhere, you are standing in 25 cm of water. There is muffled whirring sound coming from the green bathroom door. 

You can see a green door, a counter and a kitchen cabinet (in which is a can of fish (closed)) here.

The water is 25 cm high.

>open the can of fish
It seems to be locked.

The water is 29 cm high.

>unlock the can of fish
(with the pocket knife)
There are sardines in the can.

The water is 33 cm high.

>eat the sardines
That's plainly inedible.

The water is 37 cm high.

>go east
living room
From one of the couches, an orange taby blearily opens one eye and stares at you reproachfully

You can see a couch (on which is a cat) here.

The water is 41 cm high.

>feed the cat
What do you want to feed the cat?

>sardines
The cat meows hungrily and starts to eat up the sardines from your hand. As you unhook the silver key from the collar, you hear the muffled hair dryer in the bathroom and feel the water creeping around your knees
The water is 20 cm high.

>go west
kitchen
The kitchen of a basement appartment. The bathroom is to the north, the living room is east, and the entrance hall is south. There is a leak coming from somewhere, you are standing in 24 cm of water. There is muffled whirring sound coming from the green bathroom door. 

You can see a green door, a counter and a kitchen cabinet (in which is a can of fish (closed)) here.

The water is 24 cm high.

>open the green door
It seems to be locked.

The water is 28 cm high.

>unlock the green door
What do you want to unlock the green door with?

>the silver key
You unlock the green door.

The water is 32 cm high.

>go north
(first opening the green door)

bathroom
The sink is 100 cm tall. A hair dryer and a brass key rest on the sink. The hair dryer is on.

You can see a green door, a sink (on which are a hair dyer and a brass key) and a hair dryer here.

The water is 36 cm high.

>unplug the hair dryer
That's not a verb I recognise.

>turn off the hair dryer
You switch the hair dryer off.

The water is 40 cm high.

>take the brass key
Taken.

The water is 44 cm high.

>go south
kitchen
The kitchen of a basement appartment. The bathroom is to the north, the living room is east, and the entrance hall is south. There is a leak coming from somewhere, you are standing in 48 cm of water. 

You can see a green door, a counter and a kitchen cabinet (in which is a can of fish (closed)) here.

The water is 48 cm high.

>go south
entrance hall
You can here the pounding of rain outside. From beneath the front door, cold, muddy water flows down the steps into the basement appartment. The lock on the front door is brass-colored.

You can see a front door and a shelf here.

The water is 52 cm high.

>open the front door
You open the front door.

The water is 56 cm high.

>go south
street
You can see a front door here.

You made it out of the locked appartment. As you wade into the flooded street you hear a faint sparking sound from the appartment. All of a sudden a jolt of electricity courses through your body and you collapse into the muddy floodwater. THE END.
You made it out of the locked appartment. As you wade into the flooded street, the taby cat jumps onto your shoulders and licks your ear. GAME OVER.

    *** The End ***

Would you like to RESTART, RESTORE a saved game, QUIT or UNDO the last command?

* * *

justKeysandRooms
An Interactive Fiction by SenseiCanada
Release 1 / Serial number 221111 / Inform 7 v10.1.2 / D

kitchen
The kitchen of a basement apartment. The bathroom is to the north, the living room is east, and the entrance hall is south. There is a leak coming from somewhere, you are standing in 5 cm of water. There is muffled whirring sound coming from the green bathroom door. 

You can see a green door, a counter and a kitchen cabinet (closed) here.

>open
What do you want to open?

>cabinet
There is a flat can of fish in the cabinet, sardines to be exact.

The water is 5 cm high.

>take fish
Taken.

The water is 6 cm high.

>go s
entrance hall
You can here the pounding of rain outside. From beneath the front door, cold, muddy water flows down the steps into the basement appartment. The lock on the front door is brass-colored.

You can see a front door and a shelf (on which is a pocket knife) here.

The water is 7 cm high.

>take knige
You can't see any such thing.

>take knife
Taken.

The water is 8 cm high.

>unlock can with knife
There are sardines in the can
The water is 9 cm high.

>i
You are carrying:
  a sardines
  a pocket knife
  a can of fish (closed and locked)

The water is 10 cm high.

>go n
kitchen
The kitchen of a basement appartment. The bathroom is to the north, the living room is east, and the entrance hall is south. There is muffled whirring sound coming from the green bathroom door. 

You can see a green door, a counter and a kitchen cabinet (empty) here.

The water is 11 cm high.

>go e
living room
From one of the couches, an orange taby blearily opens one eye and stares at you reproachfully

You can see a couch (on which is a cat) here.

The water is 12 cm high.

>ask cat for key
The cat wriggles away, preventing you from unhooking the silver key from its colar. Perhaps some food would keep it still long enough to take the key...

The water is 13 cm high.

>give sardines to cat
The cat meows hungrily and starts to eat up the sardines from your handAs you unhook the silver key from the collar, you hear the muffled hair dryer in the bathroom and feel the water creeping around your knees
The water is 20 cm high.

>go w
kitchen
The kitchen of a basement appartment. The bathroom is to the north, the living room is east, and the entrance hall is south. There is muffled whirring sound coming from the green bathroom door. 

You can see a green door, a counter and a kitchen cabinet (empty) here.

The water is 21 cm high.

>go n
(first opening the green door)
It seems to be locked.

The water is 22 cm high.

>unlock with silver key
You can't see any such thing.

>i
You are carrying:
  a silver key
  a pocket knife
  a can of fish (closed and locked)

The water is 23 cm high.

>unlock green door
What do you want to unlock the green door with?

>silver key
You unlock the green door.

The water is 24 cm high.

>go n
(first opening the green door)
You can't, since the green door leads nowhere.

The water is 25 cm high.

* * *

justKeysandRooms
An Interactive Fiction by SenseiCanada
Release 1 / Serial number 221111 / Inform 7 v10.1.2 / D

kitchen
The kitchen of a basement apartment. The bathroom is to the north, the living room is east, and the entrance hall is south. There is a leak coming from somewhere, you are standing in 5 cm of water. There is muffled whirring sound coming from the green bathroom door. 

You can see a green door, a counter and a kitchen cabinet (closed) here.

>open cabinet
There is a flat can of fish in the cabinet, sardines to be exact.

The water is 5 cm high.

>take
What do you want to take?

>fish
Taken.

The water is 6 cm high.

>go s
entrance hall
You can here the pounding of rain outside. From beneath the front door, cold, muddy water flows down the steps into the basement appartment. The lock on the front door is brass-colored.

You can see a front door and a shelf (on which is a pocket knife) here.

The water is 7 cm high.

>take
What do you want to take?

>knife
Taken.

The water is 8 cm high.

>open can
It seems to be locked.

The water is 9 cm high.

>unlock can with knife
You unlock the can of fish.

The water is 10 cm high.

* * *

>open cabinet
There is a flat can of fish in the cabinet, sardines to be exact.

The water is 5 cm high.

>take can of fish
Taken.

The water is 6 cm high.

>go s
entrance hall
You can here the pounding of rain outside. From beneath the front door, cold, muddy water flows down the steps into the basement appartment. The lock on the front door is brass-colored.

You can see a front door and a shelf (on which is a pocket knife) here.

The water is 7 cm high.

>go n
kitchen
The kitchen of a basement appartment. The bathroom is to the north, the living room is east, and the entrance hall is south. There is muffled whirring sound coming from the green bathroom door. 

You can see a green door, a counter and a kitchen cabinet (empty) here.

The water is 8 cm high.

>go e
living room
From one of the couches, an orange taby blearily opens one eye and stares at you reproachfully

You can see a couch (on which is a cat) here.

The water is 9 cm high.

>talk to cat
That's not a verb I recognise.

>x cat
Around the cat's collar dangles a silver key.

The water is 10 cm high.

>take silver key
That seems to belong to the cat.

The water is 11 cm high.

>ask cat for key
The cat wriggles away, preventing you from unhooking the silver key from its colar. Perhaps some food would keep it still long enough to take the key...

The water is 12 cm high.

* * *

>open cabinet
There is a flat can of fish in the cabinet, sardines to be exact.

The water is 5 cm high.

>unlock cabinet
What do you want to unlock the cabinet with?

>x cabinet
You see nothing special about the cabinet.

The water is 6 cm high.

* * *

>open cabinet
There is a flat can of fish in the cabinet, sardines to be exact.

The water is 5 cm high.

>x cabinet
In the kitchen cabinet is a can of fish.

The water is 6 cm high.

>take can of fish
Taken.

The water is 7 cm high.

* * *

justKeysandRooms
An Interactive Fiction by SenseiCanada
Release 1 / Serial number 221111 / Inform 7 v10.1.2 / D

kitchen
The kitchen of a basement apartment. The bathroom is to the north, the living room is east, and the entrance hall is south. There is a leak coming from somewhere, you are standing in 5 cm of water. There is muffled whirring sound coming from the green bathroom door. 

You can see a green door, a counter and a kitchen cabinet (closed) here.

>open dor with screwdriver
You can't see any such thing.

>pick up screwdriver
Taken.

>open door
It seems to be locked.

>unlock door
(with the screwdriver)
You unlock the green door.

>open door
You open the green door.

>then what?
That's not a verb I recognise.

I beg your pardon?

>i beg yours
I only understood you as far as wanting to take inventory.

* * *

justKeysandRooms
An Interactive Fiction by SenseiCanada
Release 1 / Serial number 221111 / Inform 7 v10.1.2 / D

kitchen
The kitchen of a basement apartment. The bathroom is to the north, the living room is east, and the entrance hall is south. There is a leak coming from somewhere, you are standing in 5 cm of water. There is muffled whirring sound coming from the green bathroom door. 

You can see a green door, a counter and a kitchen cabinet (closed) here.

>pick up the screwdriver
Taken.

>kiss the screwdrivere
You can only do that to something animate.

>look under counter
You find nothing of interest.

>open door
It seems to be locked.

>break lock
You can't see any such thing.

>jam screwdriver into door
That's not a verb I recognise.

>contemplate life
That's not a verb I recognise.

>think hard
I only understood you as far as wanting to think.

>take off handle
You can't see any such thing.

>put screwdriver into door
That can't contain things.

>open door with screwdriver
That doesn't seem to fit the lock.

* * *

justKeysandRooms
An Interactive Fiction by SenseiCanada
Release 1 / Serial number 221111 / Inform 7 v10.1.2 / D

kitchen
The kitchen of a basement apartment. The bathroom is to the north, the living room is east, and the entrance hall is south. There is a leak coming from somewhere, you are standing in 5 cm of water. There is muffled whirring sound coming from the green bathroom door. 

You can see a green door, a counter and a kitchen cabinet (closed) here.

>take screwdriver
Taken.

>open door
It seems to be locked.

>unlock door
(with the screwdriver)
That doesn't seem to fit the lock.